9
5
#####
I   #
### #
#   #
# # #
# # #
# ###
#   O
#####

